"cell"	"bio_celltype"
"ACAGAAACACGGGTAA_6"	"Endothelium"
"GCAGCTGCAACACACT_7"	"Endothelium"
"AGATCCAAGTTGGGAC_6"	"Endothelium"
"ACTGTCCAGGACACTG_6"	"Endothelium"
"CGTGATAAGGCTAACG_6"	"Endothelium"
"TCGGGCAAGCAAGGAA_6"	"Endothelium"
"AAGACAAAGGATTCAA_6"	"Endothelium"
"ATTTCTGCAGTAACGG_3"	"Endothelium"
"TCGGGTGCAAATGAAC_3"	"Endothelium"
"GTGCGTGGTCCAGCGT_6"	"Endothelium"
"TCCCAGTTCGCGTGCA_6"	"Endothelium"
"GGTGATTCATCGCCTT_6"	"Endothelium"
"AATGGCTAGAGTACCG_6"	"Endothelium"
"TCACATTTCGTCCATC_6"	"Endothelium"
"GGTGAAGCAGACCCGT_6"	"Endothelium"
"GACTCTCCATCGATCA_6"	"Endothelium"
"AATGAAGTCGCAATTG_6"	"Endothelium"
"CATGGTATCTCACGAA_6"	"Endothelium"
"AAGTTCGTCCACTGAA_7"	"Endothelium"
"AGATGAATCAACTCTT_6"	"Endothelium"
"CAGATCACACATCCCT_3"	"Endothelium"
"CATGCTCGTCTAGATC_6"	"Endothelium"
"GTTAGTGAGGCATTTC_6"	"Endothelium"
"TTGCATTAGAACGTGC_6"	"Endothelium"
"AGTGATCAGCAGGGAG_7"	"Endothelium"
"TCCTCGAAGTGATAAC_3"	"Epithelium"
"TCCTCGACACTCCACT_3"	"Epithelium"
"GAGTGTTCACAGACGA_7"	"Epithelium"
"ACGTTCCGTCTTACTT_7"	"Epithelium"
"CCTCACACAAGATGGC_3"	"Epithelium"
"GAGAAATTCTAGTCAG_7"	"Epithelium"
"TGGTGATTCCAAGCTA_8"	"Epithelium"
"ACCGTTCAGAAACCCG_3"	"Epithelium"
"CACAGGCTCGTGGGTC_8"	"Epithelium"
"GTGGTTAAGCTTAAGA_3"	"Epithelium"
"AGATCGTCACTTGTCC_3"	"Epithelium"
"TCTCACGTCACAACCA_3"	"Epithelium"
"GTCACTCCATCGCCTT_3"	"Epithelium"
"TTCTCTCCAGTGTGCC_3"	"Epithelium"
"TGTTCTACAGTCGGTC_7"	"Epithelium"
"TCCTCCCAGGACGCAT_3"	"Epithelium"
"CTCCTCCTCTACTGCC_3"	"Epithelium"
"GCATTAGTCGTCAACA_3"	"Epithelium"
"CCACGAGCAACGCCCA_3"	"Epithelium"
"CCTCTCCCACGCACCA_3"	"Epithelium"
"CCGGTAGCAGAAGCGT_8"	"Epithelium"
"GTACAGTCACCAGTAT_3"	"Epithelium"
"GAGGCCTGTCACTTAG_3"	"Epithelium"
"TGCATGAGTCGTTGCG_3"	"Epithelium"
"TCCCAGTAGGGTTAGC_3"	"Epithelium"
"GACGTTATCATAGAGA_6"	"Fibroblasts"
"CCTAACCGTATACCCA_6"	"Fibroblasts"
"TTTCCTCAGCGTATAA_6"	"Fibroblasts"
"CTCCCAAAGACGCCAA_6"	"Fibroblasts"
"CATACCCGTCCATAGT_6"	"Fibroblasts"
"GAGGGTATCGCAATGT_6"	"Fibroblasts"
"GCAGGCTAGAGAGGTA_6"	"Fibroblasts"
"TTACTGTTCAGCGCGT_6"	"Fibroblasts"
"CAAGGGACATTCCTAT_6"	"Fibroblasts"
"CTCCCAATCCGTGGCA_6"	"Fibroblasts"
"TGAGGTTCATCTGCGG_6"	"Fibroblasts"
"TCGGGTGTCCTCATAT_6"	"Fibroblasts"
"GACCTTCGTAATACCC_6"	"Fibroblasts"
"ATTGTTCCAACCGTGC_6"	"Fibroblasts"
"TAAGCCATCCCAGCGA_6"	"Fibroblasts"
"ACTTAGGCAAATCCCA_6"	"Fibroblasts"
"GTGGAAGTCCACGGAC_6"	"Fibroblasts"
"CAGATTGAGCTCATAC_6"	"Fibroblasts"
"GGAACCCGTAATTAGG_6"	"Fibroblasts"
"CCATCACAGTGGAAGA_6"	"Fibroblasts"
"GACCGTGTCTGCGATA_6"	"Fibroblasts"
"ACAAAGAGTTCCTTGC_6"	"Fibroblasts"
"TTGGGCGCACAGAGAC_6"	"Fibroblasts"
"TAGTGCAGTGAGCAGT_6"	"Fibroblasts"
"TCATATCGTCCAGGTC_6"	"Fibroblasts"
"TAGACCAAGACCTCCG_3"	"Immune"
"AGAAGTATCAATCCGA_3"	"Immune"
"GGAGCAATCTCGTGAA_3"	"Immune"
"GTAACACGTATCGTAC_3"	"Immune"
"TCATTCATCCCTGTTG_6"	"Immune"
"TCGGGCAGTAACGGTG_3"	"Immune"
"TATCGCCCAACTAGAA_6"	"Immune"
"CTGTCGTCAAGAGTTA_3"	"Immune"
"AAGACAACAGACAAGC_3"	"Immune"
"CAACCTCTCACTGATG_6"	"Immune"
"CTGTAGACACCCTATC_3"	"Immune"
"ACTGATGGTCTGTAGT_6"	"Immune"
"TACACCCGTTTAGAGA_3"	"Immune"
"TGGTGATTCAGAGTTC_3"	"Immune"
"AGGAAATCACGCAAAG_7"	"Immune"
"GGGACCTTCCACTGAA_3"	"Immune"
"GTATTTCAGAATCGCG_3"	"Immune"
"GGTGAAGTCTATCGGA_6"	"Immune"
"CTTGAGACATTGCTTT_6"	"Immune"
"CACATGACATGACTCA_8"	"Immune"
"TCTACATCATGGAATA_6"	"Immune"
"TATTGCTTCCTGTACC_6"	"Immune"
"TTCATTGTCTAGTGAC_3"	"Immune"
"GGAATGGGTCACTCTC_3"	"Immune"
"TCCTCGAAGAAGAACG_6"	"Immune"
"ATTTCTGCATCCGAGC_6"	"Muscle"
"TCGTAGATCTCTGCCA_8"	"Muscle"
"TCCCAGTCATACTGAC_6"	"Muscle"
"TGGGCTGCAAACTGCT_6"	"Muscle"
"TTAGTCTCACAGCATT_6"	"Muscle"
"CGGGCATGTGATACAA_6"	"Muscle"
"TTTGACTTCCAGCTCT_6"	"Muscle"
"TACTGCCGTGGGCTCT_6"	"Muscle"
"CAGTTCCGTCGTTGGC_6"	"Muscle"
"TGAGGTTAGACGGTCA_6"	"Muscle"
"TGTTCTAAGCACTCGC_6"	"Muscle"
"TGCTGAATCAGCTGTA_6"	"Muscle"
"GCACGGTTCGCCTCTA_6"	"Muscle"
"ACAGGGACAGAGTTCT_6"	"Muscle"
"CACATGAGTCGAGATG_6"	"Muscle"
"TCTCAGCCAAGGCGTA_6"	"Muscle"
"CAAAGAAGTTAGGAGC_6"	"Muscle"
"AAGCCATTCCATCCGT_6"	"Muscle"
"AGGTAGGTCGCTACAA_6"	"Muscle"
"GCAGGCTTCGTCACCT_6"	"Muscle"
"TTCTAACTCGTGGCGT_6"	"Muscle"
"AAAGGGCCAGAAATCA_6"	"Muscle"
"GCAACATAGTAATACG_6"	"Muscle"
"AAGACTCAGGAACTCG_6"	"Muscle"
"ATGACCACAAACGAGC_7"	"Muscle"
"AGTGTTGGTTGCCGAC_6"	"Myo.Meso"
"TCCGATCCATGCAGCC_6"	"Myo.Meso"
"TACACCCAGTGAACAT_6"	"Myo.Meso"
"CAGAGCCAGCGGGTAT_6"	"Myo.Meso"
"CCGGACAGTTCTGACA_6"	"Myo.Meso"
"TATTGCTGTTCTGACA_6"	"Myo.Meso"
"GAGTCATGTACTCCGG_6"	"Myo.Meso"
"TCGGGCAGTCGCAGTC_6"	"Myo.Meso"
"AGGCATTTCTCCAATT_6"	"Myo.Meso"
"CGAGAAGTCTGCGTCT_6"	"Myo.Meso"
"ATTACCTGTCTGATAC_6"	"Myo.Meso"
"CACTAAGCAATTGAAG_6"	"Myo.Meso"
"AGACACTTCCACGAAT_6"	"Myo.Meso"
"TCTTCCTCATCTGTTT_6"	"Myo.Meso"
"AGCTCAATCCCTCTCC_6"	"Myo.Meso"
"TGCAGATGTGTCTAAC_6"	"Myo.Meso"
"CATGGTACATGCAGGA_6"	"Myo.Meso"
"CTTCAATCATGTGGTT_6"	"Myo.Meso"
"AACCCAAAGTTAGTGA_6"	"Myo.Meso"
"GGTGGCTTCGCTAATG_6"	"Myo.Meso"
"GGGCTACTCCACATAG_6"	"Myo.Meso"
"CTCCACAAGGGTCACA_6"	"Myo.Meso"
"GATGCTAAGGTGCCAA_6"	"Myo.Meso"
"TCATACTCACACGTGC_6"	"Myo.Meso"
"GATTCGACAGAGGAAA_6"	"Myo.Meso"
"TGTAACGGTCAGTCTA_6"	"Neural"
"TCACGCTCATGAATAG_6"	"Neural"
"TGCGACGTCACCTGTC_3"	"Neural"
"GTGTTAGTCTAGCCAA_6"	"Neural"
"CTTTCAAAGCTAGCCC_6"	"Neural"
"GTAGGTTTCACTGAAC_6"	"Neural"
"CTCAATTCAGCACGAA_6"	"Neural"
"TGTTCTAGTTGTCCCT_6"	"Neural"
"CTGCCTACACTGGACC_6"	"Neural"
"GATCGTACATAGAAAC_6"	"Neural"
"TGGATCAAGGCTCAAG_6"	"Neural"
"ATGCATGAGCTGAAGC_6"	"Neural"
"GTAGGTTTCCACGTGG_6"	"Neural"
"CCCGAAGAGGGTAGCT_6"	"Neural"
"GCCATGGAGAGGTATT_6"	"Neural"
"CTGGACGAGCTAGCCC_6"	"Neural"
"TGGTACACACTGGAAG_3"	"Neural"
"TCCTCTTCACAACATC_7"	"Neural"
"AATGCCATCTGCGGAC_6"	"Neural"
"TCAGGTACACGGCACT_6"	"Neural"
"GATTGGTAGATACGAT_6"	"Neural"
"TATACCTTCTTGGTCC_6"	"Neural"
"CGGGTCAAGATTGATG_6"	"Neural"
"TACTTCATCCGTGACG_6"	"Neural"
"TCCTCTTGTGAGCTCC_6"	"Neural"
"CATCGGGCACTTCAAG_8"	"Pericytes"
"CAGCAATTCGTAACTG_6"	"Pericytes"
"ATTTCTGAGCCAGACA_6"	"Pericytes"
"AGGACTTAGTATGAAC_6"	"Pericytes"
"CCGAACGGTCCACGCA_6"	"Pericytes"
"GCAGGCTGTGAACTAA_6"	"Pericytes"
"AAACCCACATGCCATA_6"	"Pericytes"
"TCAATCTCACTAGTAC_8"	"Pericytes"
"GCCCAGAGTACAGAAT_6"	"Pericytes"
"ATTCCTAGTGGAAATT_6"	"Pericytes"
"GGTTGTAAGTTCGGTT_6"	"Pericytes"
"CGATGCGCAGCGACAA_7"	"Pericytes"
"TTGGGTACAAGCGATG_6"	"Pericytes"
"CATTGTTTCACTCTTA_6"	"Pericytes"
"ATCCACCCAATCCTTT_6"	"Pericytes"
"TATACCTAGAGGTTTA_6"	"Pericytes"
"GGGATGACAAAGGCGT_7"	"Pericytes"
"CTCCATGTCTCTGCCA_6"	"Pericytes"
"CTACCTGTCTGTCTCG_6"	"Pericytes"
"GAGGGTACAGGACAGT_6"	"Pericytes"
"CAACCTCGTGCCTAAT_7"	"Pericytes"
"GAGTCATCACTGGCGT_6"	"Pericytes"
"TCGCTCATCGTTACCC_6"	"Pericytes"
"TGTCCTGGTCGTACTA_6"	"Pericytes"
"CTACATTTCCATTCGC_6"	"Pericytes"
